11111111111111111111
12222222222222222221
12112111211211121121
12112111211211121121
12222222222222222221
11112121111112121111
11112121111112121111
11112121111112121111
12222222222222222221
12112111211211121121
12222222211222222221
12112112111121121121
12112112111121121121
12222222222222222221
11111111111111111111